Блаттофобия – страх при виде тараканов, жуков
Вакцинофобия – боязливость, появляющаяся при мысли о вакцинах
Катоптрофобия – испуг, появляющийся при виде зеркал
Нумерофобия – страх, испытываемый перед числами
Педофобия – страх родить ребенка
Андрофобия — страх мужчин
Филофобия — боязнь влюбиться
Антропофобия — страх людей
Никтофобия — страх темноты
Эфебифобия — боязнь молодежи
Нозокомефобия — страх больниц
Апифобия — страх пчел
Кинофобия — страх собак
Иофобия — страх ядов/отравиться
Гинофобия — страх женщин
Ихтиофобия — боязнь рыб
Клаустрофобия — страх замкнутых пространств
Педиофобия — страх кукол
Арахнофобия — страх пауков
Виккафобия — страх колдунов
Талассофобия — боязнь моря
Радиофобия — страх радиации
Виргинитифобия — страх изнасилования
Аквофобия - боязнь воды
Аутомизофобия - боязнь испачкаться 
Богифобия - боязнь всего потустороннего и мистического 
Герпетофобия - боязнь змей 
Гомофобия - проявляется в страхе (вплоть до ненависти) к гомосексуалистам 
Дисморфорбия - боязнь своего внешнего вида 
Клейзиофобия - боязнь воров и ограблений 
Криофобия - боязнь холода 
Лигрофобия - боязнь темноты 
Метилофобия - боязнь спиртных напитков 
Партенофобия - боязнь девственниц 